tileset.png 5 128 64
portal.png 128 64
runa.png 128 64
spirit.png 8 32 32
15 15
3 3 3 3 3 3 3 3 3 3 3 3 3 3 3
3 4 0 0 0 0 0 0 0 0 0 0 2 2 3
3 0 2 3 3 0 2 2 2 2 3 0 0 2 3
3 0 3 3 0 0 0 0 0 0 3 0 0 0 3
3 0 3 0 2 0 0 0 0 0 3 0 0 0 3
3 0 0 0 0 2 2 2 2 0 0 0 0 0 3
3 0 2 0 0 2 3 3 2 0 0 0 0 0 3
3 0 2 0 0 2 3 3 2 0 0 0 0 0 3
3 0 2 0 0 2 2 2 2 0 0 2 0 0 3
3 0 2 0 0 0 0 0 0 0 3 2 0 0 3
3 0 3 3 3 0 0 0 0 3 3 2 0 0 3
3 0 0 0 0 0 0 0 2 2 2 2 0 0 3
3 2 0 0 0 0 0 0 0 0 0 0 0 0 3
3 2 2 0 0 0 0 0 0 0 0 0 0 4 3
3 3 3 3 3 3 3 3 3 3 3 3 3 3 3
player 1 1
altar_exit 13 13
runa 1 3
runa 1 9
runa 2 5
runa 4 3
runa 4 11
runa 8 10
runa 9 3
runa 11 5
runa 12 2
runa 13 7
